NO ./rsrc/ananas.xpm
SO ./rsrc/ananas.xpm
EA ./rsrc/ananas.xpm
WE ./rsrc/ananas.xpm
F 200,150,50
C 100,100,100

1111111111
1000000001
1000000001
100N000 01
1000000001
1000000001
1111111111
