NO ./rsrc/ananas.xpm
SO ./rsrc/ricardo.xpm
EA ./rsrc/sonic.xpm
WE ./rsrc/coconut.xpm
F 200,150,50
C 100,100,100

1111111111
1001000001
1111000001
100E000001
100000000111
10000   00001
1111111 11111
      1 1   
111111   11
1         1
1        1
1    1111    11
1        111111
111111111111111
